RRRRRRGR
RGGGRRGR
RGGGRRGR
RGGGRRGR
RRRRRRGR
RGRGRRGR
GGGGGRGR
RRGRRRGR