RRRRRRGR
RGGGRRGR
RGGGRRGR
RGGGRRGR
RRRRRRGR
RGRGRRXR
GGGGGRXR
RRGRRRGR
